............................
..........LLL...............
.........LLBLL..............
...........W................
X..........W................
X.P........W........X.......
XXXXXXXXXXSWSXXXX.XX...X....
XXXX.....XXXX......XX.......
XXX......XXXX...............
............................
............................
............................
............................
............................
............................
............................
