............................
............................
............................
..................SBBSSBBBBB
X.........XXXX.XXXXXXBB.....
X.P...XXXXXXX...............
XLLLLLXXXXXXXX.XXXXX....XXXX
XL.......XXXX......XXXXXX...
XL.......XXXX...............
...........L................
...........LLLLLLLLLLLLLLLLL
............................
............................
............................
............................
............................
