..............................
..............................
..............................
..........XX.XX.XX..X.........
X......................X......
X.P.................X.....X...
XXXXXXX......XXXX.XX...X.X.X..
XXXX.....XXXX......XX.........
XXX......XXXX.................
..............................
..............................
..............................
..............................
..............................
..............................
..............................
..............................
..............................
